TILEMAP
36 28 							-- Size of tile map in tiles
16 16 							-- Tile size & block size
images/bloques.png 	-- Tilesheet
2 2 								-- Number of tiles in tilesheet
111111111111111111111111111111111111
11                                11
11                                11
11                                11
11                                11
11                                11
11     2222222222222222222222     11
11     11        11        11     11
11     11        11        11     11
11     11        11        11     11
11     1122222222112222222211     11
11     11        11        11     11
11     11        11        11     11
11     11        11        11     11
11     1122222222112222222211     11
11                                11
11                                11
11                                11
11    222222222222222222222222    11
11                                11
11                                11
11                                11
11        2222222222222222        11
11                                11
11                                11
11                                11
112222222222            222222222211
111111111111444444444444111111111111
