TILEMAP
36 28 							-- Size of tile map in tiles
16 32 							-- Tile size & block size
images/blocks.png 	-- Tilesheet
2 2 								-- Number of tiles in tilesheet
111111111111111111111111111111111111
11                                11
11                                11
11                                11
11                                11
11                                11
11       444444441144444444       11
11               11               11
11               11               11
11               11               11
1111   4444444444114444444444   1111
11               11               11
11               11               11
11               11               11
11   44444444444411444444444444   11
11                                11
11                                11
11                                11
11   4444                  4444   11
11                                11
11                                11
11                                11
11   44                      44   11
11                                11
11                                11
11                                11
114444444444            444444444411
111111111111333333333333111111111111

