TILEMAP
36 28							-- Size of tile map in tiles
16 16 							-- Tile size & block size
images/bloques.png 	-- Tilesheet
2 2 							-- Number of tiles in tilesheet
111111111111111111111111111111111111
11                                11
11                                11
11                                11
11                                11
11                                11
112222         111111         222211
11                                11
11                                11
11                                11
11    222222            222222    11
11    11                    11    11
11    11                    11    11
11    11                    11    11
11    112222            222211    11
11    11                    11    11
11    11                    11    11
11    11                    11    11
11    11222222        22222211    11
11    11                    11    11
11    11                    11    11
11    11                    11    11
11    112222222222222222222211    11
11                                11
11                                11
11                                11
111122222222222222222222222222221111
111111111111111111111111111111111111

