TILEMAP
36 28							-- Size of tile map in tiles
16 16 							-- Tile size & block size
images/bloques.png 	-- Tilesheet
2 2 							-- Number of tiles in tilesheet
111111111111111111111111111111111111
11                                11
11                                11
11                                11
11                                11
11                                11
11       222222221122222222       11
11               11               11
11               11               11
11               11               11
1111   2222222222112222222222   1111
11               11               11
11               11               11
11               11               11
11   22222222222211222222222222   11
11                                11
11                                11
11                                11
11   2222                  2222   11
11                                11
11                                11
11                                11
11   22                      22   11
11                                11
11                                11
11                                11
112222222222            222222222211
111111111111444444444444111111111111

